1011111111111111111111111111111111111111111111111111111111
1011100000111111111111111111111111111111111111111111111111
1011101110111111111111111111111111111111111111111111111111
1011101110111111111111111111111111111111111111111111111111
1011101110111111000000001111111111111111111111111111111111
1011101110111111011111101111111111111111111111111111111111
1010001100111111011111101111111111111111111111111111111111
1010111101111111011111101111111111111111111111111111111111
1010111100111111011111101111111111111111111111111111111111
1000111110111111011111101111111111111111111111111111111111
1111111110000000011111101111111111111111111111111111111111
1111111111111111111110001111111111111111111111111111111111
1111111111111111111110111111111111111111111111111111111111
1111111111111111111100111110000000000000000000000000000000
1111111111111111111101111110111111111111111111111111111111
1111111111111111111101111110111111111111111111111111111111
1111111111111111111101111110111111111111111111111111111111
1111111111111111111101111110111111111111111111111111111111
1111111111111111111100011110111111111111111111111111111111
1111111111111111111111011110111111111111111111111111111111
1111111111111111111111011110111111111111111111111111111111
1111111111111111111111001110111111111111111111111111111111
1111111111111111111111110010111111111111111111111111111111
1111111111111111111111111000111111111111111111111111111111
1111111111111111111111111111111111111111111111111111111111
1111111111111111111111111111111111111111111111111111111111
1111111111111111111111111111111111111111111111111111111111
1111111111111111111111111111111111111111111111111111111111
1111111111111111111111111111111111111111111111111111111111
1111111111111111111111111111111111111111111111111111111111
1111111111111111111111111111111111111111111111111111111111