111111111111111111111111111111111111111111111111111111111111111
101000000000000000000000000000000000000000000000000000000001111
101011111011011111111011111111111011110111111011111011111011111
100011111011000000001011100000011011110111111011110001111011111
101111111011101111011011101111000011110000000011100000000000111
101111100011101111011011101111011011111111111111111111111110111
101000001111101111011011101111011000000000000000000000000000111
101111101111101111000011101111011011111111111111111111111110111
100011101111101100011110000000011011000000000000111111111110111
111011101100001110111110111111111111011111111110111111111111111
100011101101111110111000001000000000011011111110000000000011100
111011111100001110111011111111011111011000000000111111111110101
111000000111111110100011111111011111011111111111111110000000101
111011111111101110111011110111011111011101111011101110111111101
111011111111101110111011110111011111011101111011101110110000101
111011111111100110111011110111011111011100000000000000111110101
111011111111110000111000000000000111011101111011111110111110101
100000000000111111110011110111111111011101101011111110111110101
111111111110111111100111110100000000011101101000000110000000101
100000000000100000101111110101111111111101101011111110111101101
111011111101111110101111110101111000000001101011111110111101101
111011111101111110101111110101111011111111101011000000110000001
111000001100000000101111110101111000000100000011101111110111001
111111101101111110101111110101111011111101111111101100000001101
111000001101110110101111110101000011111101110000001101111101101
111111111101110110101111110101111010000000110111111101111101101
111011110001110110101111110101111011111110110111110000000001101
111011110111110110001111110101111010111110110111110111101111101
111010000111000010111111110101111010111110110100000111101100001
111011110111011110111111110101111010111110110101111111101111111
111011110111011110111111110100000010111110110001100000000000011
111011110111011110111111110111111110111110111111111111111111111
111000000110000000100000000000000000000000000000000000000000011
111111111111111111111111111111111111111111111111111111111111111