010000000000000000000000000000000000000000000000000000000000000
010111111111111111111111111111111111111111111111111111111110000
010100000100100000000100000000000100001000000100000100000100000
011100000100111111110100011111100100001000000100001110000100000
010000000100010000100100010000111100001111111100011111111111000
010000011100010000100100010000100100000000000000000000000001000
010111110000010000100100010000100111111111111111111111111111000
010000010000010000111100010000100100000000000000000000000001000
011100010000010011100001111111100100111111111111000000000001000
000100010011110001000001000000000000100000000001000000000000000
011100010010000001000111110111111111100100000001111111111100000
000100000001110001000100000000100000100111111111000000000001000
000111111000000001011100000000100000100000000000000001111111000
000100000000010001000100001000100000100010000100000001000000000
000100000000010001000100001000100000100010000100000001001111000
000100000000011001000100001000100000100011111111111111000001000
000100000000001111000111111111111000100010000100000001000001000
011111111111000000001100001000000000100010000100000001000001000
000000000001000000011000001011111111100010000100000001111111000
011111111111011111010000001010000000000010000100000001000000000
000100000010000001010000001010000111111110000100000001000000000
000100000010000001010000001010000100000000000100111111000000000
000111110011111111010000001010000100000011111100010000000000000
000000010010000001010000001010000100000010000000010011111110000
000111110010001001010000001010111100000010001111110010000010000
000000000010001001010000001010000101111111001000000010000010000
000100001110001001010000001010000100000001001000001111111110000
000100001000001001110000001010000101000001001000001000010000000
000101111000111101000000001010000101000001001011111000010000000
000100001000100001000000001010000101000001001010000000010000000
000100001000100001000000001011111101000001001110011111111111111
000100001000100001000000001000000001000001000000000000000000000
000111111001111111011111111111111111111111111111111111111100000
000000000000000000000000000000000000000000000000000000000000000