10111111111111111111
10111000001111111111
10111011101111111111
10111011101111111111
10111011101111110000
10111011101111110111
10100011001111110111
10101111011111110111
10101111001111110111
10001111101111110111
11111111100000000111
11111111111111111111