111111111111111111111111111111111111111111111111111111111111111
111110000011111111111111111111111111111111111111111111111111111
111110111011111111111111111111111111111111111111111111111111111
111110111011111111111111111111111111111111111111111111111111111
111110111011111100000000111111111111111111111111111111111111111
111110111011111101111110111111111111111111111111111111111111111
101000110011111101111110111111111111111111111111111111111111111
101011110111111101111110111111111111111111111111111111111111111
101011110011111101111110111111111111111111111111111111111111111
100011111011111101111110111111111111111111111111111111111111111
111111111000000001111110111111111111111111111111111111111111111
111111111111111111111000111111111111111111111111111111111111111
111111111111111111111011111111111111111111111111111111111111111
111111111111111111110011111000000000000000000000000000000000011
111111111111111111110111111011111111111111111111111111111111111
111111111111111111110111111011111111111111111111111111111111111
111111111111111111110111111011111111111111111111111111111111111
111111111111111111110111111011111111111111111111111111111111111
111111111111111111110001111011111111111111111111111111111111111
111111111111111111111101111011111111111111111111111111111111111
111111111111111111111101111011111111111111111111111111111111111
111111111111111111111100111011111111111111111111111111111111111
111111111111111111111111001011111111111111111111111111111111111
111111111111111111111111100011111111111111111111111111111111111
111111111111111111111111111111111111111111111111111111111111111
111111111111111111111111111111111111111111111111111111111111111
111111111111111111111111111111111111111111111111111111111111111
111111111111111111111111111111111111111111111111111111111111111
111111111111111111111111111111111111111111111111111111111111111
111111111111111111111111111111111111111111111111111111111111111
111111111111111111111111111111111111111111111111111111111111111
111111111111111111111111111111111111111111111111111111111111111
111111111111111111111111111111111111111111111111111111111111111
111111111111111111111111111111111111111111111111111111111111111